11 11
L L L L L L L L L L L 
L L M M M M M M M M M 
L L M C C C C C C C C 
L L M C T T T T C T T 
L L M C T B B T C T B 
L L M C T B B T C T B 
M M M C T T B T C T B 
C C C C C T T T C T T 
T T T T C C C C C C C 
T B B T C T T T T T T 
T B B T C T T T T T T 














