15 15
B B C C B B L L C T T C C B B
B T T T C C C L C C T C T T B
B C C C T C T L L C T C T C B
C T T C T B B L C C B T T T C
T C C B B B M M M C B B B B C
B B C C B B L L C T T C C B B
B T T T C C C L C C T C T T B
B C C C T C T L L C T C T C B
C T T C T B B L C C B T T T C
T C C B B B M M M C B B B B C
B B C C B B L L C T T C C B B
B T T T C C C L C C T C T T B
B C C C T C T L L C T C T C B
C T T C T B B L C C B T T T C
T C C B B B M M M C B B B B C