20 20
L L L T C T T T C T L L L L L L L T C T
T L L T C T T T C T T L L L L L L T C T
T L L T C T T T C T T L L L L L L T C T
T T T T C C C C C T T T T L L L T T C C
C C C C C T T T C C C C T L L L L T C T
T C T T C T L T C T T C T L L L L T C T
T C T T C T L T C T T C T L L T L T C T
T C T T C T T T C T T C T L L T T T C T
C C C C C C C C C C C C T L L T C C C C
T C T T C T T T C T T C T T T T C T C T
T C T T C T T T C T T C C C C C C T C T
T C C C C T T T C T T C T T C T T T C T
T C T T C T T T C T T C T T C T T T C T
C C T T C C C C C C C C T T C C C C C C
T C C C C T T T C T T C C C C T T T C T
T C T T C T L T C T T C T T C T L T C T
T C T T C T L T C T T C T T C T L T C T
T C C C C T T T C T T C C C C T T T C T
C C T T C C C C C C C C T T C C C C C C
T C T T C T T T C T T C T T C T T T C T